1 1 1 1 1 1 1 1 1 1 1 1 1 1 1 1 1 1 1 1 
1 1 1 1 1 1 1 1 1 1 1 1 1 1 1 1 1 1 1 1 
1 1 1 1 1 1 1 1 1 1 1 1 1 1 1 1 1 1 1 1 
1 1 1 1 1 1 29 1 1 1 1 1 1 1 1 1 1 1 1 1 
1 1 1 1 1 29 1 1 1 1 1 1 1 1 1 1 1 1 1 1 
1 1 1 29 1 1 1 1 1 1 1 1 1 1 1 1 1 1 1 1 
1 1 1 1 1 1 1 1 1 1 1 1 1 1 1 1 1 1 1 1 
1 1 1 29 1 1 1 1 1 1 1 1 1 25 1 1 1 1 1 1 
1 1 1 1 1 1 25 1 1 1 1 1 1 1 1 1 1 1 1 1 
1 1 1 1 25 1 1 1 1 1 1 1 1 1 1 1 1 1 1 1 
1 1 1 1 1 1 1 1 1 1 1 999 999 999 1 1 1 1 1 1 
1 1 1 1 25 1 1 1 1 1 999 1 1 1 1 1 1 1 1 1 
1 1 1 1 1 1 1 1 1 1 1 1 999 1 1 1 1 1 1 1 
1 1 1 1 25 1 1 1 1 1 1 1 1 1 999 1 1 999 1 1 
1 1 1 1 1 1 1 1 25 1 1 1 1 1 1 1 1 1 1 1 
1 1 1 1 1 1 1 1 1 25 25 1 1 1 1 1 1 1 1 1 
1 1 1 1 1 1 1 1 1 1 1 1 1 1 1 1 1 1 1 1 
1 1 1 1 1 1 1 1 1 1 1 1 1 1 1 1 1 1 1 1 
1 1 1 1 1 1 1 1 1 1 1 1 1 1 1 1 1 1 1 1 
1 1 1 1 1 1 1 1 1 1 1 1 1 1 1 1 1 1 1 1 
