1 1 1 1 1 1 1 1 1 1 1 1 1 1 1 1 1 1 1 1 
1 1 1 1 1 1 1 1 1 1 1 1 1 1 1 1 1 1 1 1 
1 1 1 1 1 1 1 1 1 1 1 1 1 1 1 1 1 1 1 1 
1 1 1 25 1 25 1 1 1 1 1 1 1 1 1 1 1 1 1 1 
1 1 1 25 1 1 1 1 1 1 1 34 1 34 1 1 1 1 1 1 
1 1 1 1 25 1 1 1 1 1 1 1 1 1 1 1 1 1 1 1 
1 1 1 1 25 1 1 1 1 1 34 1 1 1 1 1 1 1 1 1 
1 1 1 1 1 1 1 25 1 1 1 1 1 1 1 1 1 1 1 1 
1 1 999 1 1 1 1 1 1 1 1 1 1 1 29 1 1 1 1 1 
1 1 1 1 1 1 1 1 1 1 1 1 1 1 1 1 1 1 1 1 
1 1 1 1 1 1 1 1 1 1 1 25 1 1 1 1 1 1 1 1 
1 999 1 1 1 1 999 1 1 1 1 1 1 1 1 1 1 1 1 1 
1 1 999 1 999 1 1 1 1 1 25 1 1 1 1 1 1 1 1 1 
1 1 999 999 1 999 1 1 1 1 25 1 1 1 1 1 1 1 1 1 
1 1 1 1 1 1 1 1 1 1 25 25 1 1 1 1 1 1 1 1 
1 1 1 1 1 1 1 1 1 1 1 1 1 1 9 9 1 1 1 1 
1 1 33 1 1 1 1 1 1 1 1 1 1 1 1 9 1 1 1 1 
1 1 33 1 1 1 9 9 1 9 1 1 9 1 1 1 1 1 1 1 
1 1 1 1 1 1 1 1 9 1 1 1 1 9 1 1 1 1 1 1 
1 1 1 1 1 9 1 9 1 1 1 1 1 1 1 1 1 1 1 1 
