25 25 25 25 25 25 25 25
25 999 0 0 0 0 0 25
25 0 0 0 0 0 0 25
25 0 0 0 0 0 999 25
25 25 25 25 25 25 25 25