25 25 25 26 25 25 26 25 25 26 25 26 25 26 25 27 25 25 25 28 28 28 28 28 28 28 28 28 28 28 25 25 25 25 25 25 25 25 25 25
25 0 0 0 25 0 25 0 25 34 25 0 0 0 0 0 0 0 0 0 0 0 0 0 0 0 0 0 0 0 0 0 0 0 0 0 0 0 0 25
25 0 9 0 25 0 0 0 0 0 0 0 0 0 0 0 0 0 0 0 0 0 0 0 0 0 0 0 0 0 0 0 0 0 0 0 0 0 0 25
25 0 0 0 25 0 0 0 0 0 0 0 0 0 0 0 0 0 0 0 0 0 0 0 0 0 0 0 0 0 0 0 0 0 0 0 0 0 0 28
25 0 0 0 25 0 0 0 0 0 0 0 0 0 0 0 25 0 0 0 0 0 0 0 0 0 0 0 0 0 0 0 0 0 0 0 0 0 0 28
25 34 25 25 25 0 0 0 0 0 0 0 0 0 0 25 34 0 0 0 0 0 0 0 0 0 0 0 0 0 0 0 0 0 0 0 0 0 0 28
25 0 0 0 25 25 0 0 0 0 0 0 0 0 0 0 25 0 0 0 0 0 0 0 0 0 0 0 0 0 0 0 0 0 0 0 0 0 0 28
25 0 0 0 0 25 0 0 0 0 0 0 6 0 0 0 0 0 0 0 0 0 0 0 0 0 0 0 0 0 0 0 0 0 0 0 0 0 0 28
28 0 0 0 0 0 0 0 0 0 0 6 6 0 0 0 0 0 0 0 0 0 0 0 0 0 0 0 0 0 0 0 0 0 0 0 0 0 0 28
28 0 0 0 0 0 0 0 0 0 0 6 6 0 0 0 0 0 0 0 0 0 0 0 0 0 0 0 0 0 0 0 0 0 0 0 0 0 0 28
25 0 0 0 0 0 0 0 0 0 0 0 6 0 0 0 0 0 0 0 0 0 0 0 0 0 0 0 0 0 0 0 0 0 0 0 0 0 0 25
28 34 32 32 32 32 32 32 30 32 32 27 30 26 25 34 25 25 25 25 25 31 31 31 31 31 25 25 25 31 31 31 31 31 25 25 25 0 0 25
29 0 0 0 0 0 0 0 0 0 0 0 0 0 0 7 25 0 0 0 0 0 0 0 0 0 0 0 0 0 0 0 0 0 0 0 0 0 0 25
29 0 0 0 0 0 0 31 0 0 31 0 0 0 25 0 0 25 0 0 25 0 0 25 0 0 25 0 25 0 0 0 0 0 0 0 0 0 0 25
29 0 0 0 0 0 0 0 0 0 0 0 0 0 0 0 28 28 28 28 28 28 28 0 0 0 0 0 0 0 0 0 0 0 0 0 0 0 0 26
29 0 0 0 0 0 0 0 0 0 0 0 0 0 0 0 28 0 0 2 0 0 28 0 0 0 0 0 0 0 0 0 0 0 0 0 0 0 0 26
29 0 0 0 0 0 0 0 0 0 0 7 0 0 0 0 28 6 0 5 0 3 28 0 0 0 0 0 0 0 0 0 0 0 0 0 0 0 0 26
29 0 0 0 0 0 0 0 0 0 0 0 0 0 0 0 28 0 0 0 0 0 28 0 0 0 0 0 0 0 0 0 0 0 0 0 0 0 0 26
29 0 0 0 4 0 0 0 0 0 4 0 0 0 0 0 26 26 34 26 26 26 26 26 26 26 26 26 26 26 26 26 26 26 26 26 26 26 26 26
29 2 0 0 0 0 0 0 0 0 0 0 0 0 0 0 0 0 0 0 0 0 4 0 0 0 0 4 0 0 0 0 0 4 0 0 0 999 0 26
25 25 0 25 25 25 25 25 25 25 25 0 0 0 0 25 25 25 25 25 25 25 0 25 6 25 0 25 0 25 0 25 25 25 25 25 25 25 25 25
25 30 30 30 30 30 30 30 30 30 30 30 30 30 30 25 25 25 25 25 25 25 25 25 25 25 25 25 25 25 25 25 25 25 25 25 25 25 25 25