0 0 0 0 0 0 0 0 0 0 0 0 0 25 25 25 0 0 0 0 0 0 0 0 0 0 0 0 0 0 
0 0 25 25 25 25 25 27 27 27 27 27 27 27 34 27 27 27 27 27 27 27 27 27 27 27 0 0 0 0 
0 0 25 0 0 0 0 0 0 6 0 0 0 0 0 0 0 0 0 6 0 0 0 0 0 27 0 0 0 0 
0 0 25 2 0 0 0 0 0 0 0 0 0 0 0 0 0 0 0 0 0 0 4 0 0 27 0 0 0 0 
0 0 25 0 0 0 4 0 0 0 0 0 0 0 4 0 0 0 0 0 0 0 0 0 0 27 0 0 0 0 
0 0 25 0 0 0 27 27 27 27 27 27 27 27 34 27 27 27 27 27 27 27 27 0 0 27 0 0 0 0 
0 0 25 0 0 0 27 3 0 0 0 0 0 0 0 0 0 0 0 0 0 6 27 0 2 27 0 0 0 0 
0 0 25 0 4 0 27 0 0 0 4 0 0 0 0 0 0 0 4 0 0 0 27 0 0 27 0 0 0 0 
0 0 25 0 0 0 27 0 0 26 25 26 26 26 26 26 26 26 26 26 0 0 27 0 0 27 0 0 0 0 
0 0 25 8 0 0 27 0 0 26 6 0 0 0 7 0 0 0 0 26 2 0 27 0 0 27 0 0 0 0 
0 0 25 0 0 0 27 0 0 26 0 0 0 0 0 0 0 0 0 26 0 0 27 0 0 27 0 0 0 0 
0 0 25 0 0 0 27 7 0 26 0 25 25 25 25 25 25 25 2 26 0 0 27 0 0 27 0 0 0 0 
0 0 25 0 2 0 27 0 0 26 0 25 0 0 5 0 0 25 0 26 0 0 27 4 0 27 0 0 0 0 
0 0 25 0 0 0 27 0 0 25 0 25 0 0 0 0 0 25 0 26 0 0 27 0 0 27 25 25 25 25 
0 0 25 0 0 0 27 0 4 34 0 4 0 0 999 0 0 4 0 34 4 0 27 0 0 34 0 7 25 25 
0 0 25 0 0 0 27 0 0 26 0 25 0 0 0 0 0 25 0 26 0 0 27 0 0 27 25 25 25 25 
25 25 25 0 0 0 27 0 0 26 0 25 0 0 6 0 0 25 0 26 0 0 27 0 0 27 0 0 0 0 
7 0 25 0 4 0 27 0 0 26 0 25 25 25 25 25 25 25 0 26 0 0 27 0 0 27 0 0 0 0 
0 0 34 0 0 0 27 6 0 26 2 0 0 0 0 0 0 0 0 26 4 0 27 0 3 27 0 0 0 0 
25 25 25 0 0 0 27 0 0 26 26 26 26 26 26 26 26 26 26 26 0 0 27 0 0 27 0 0 0 0 
0 0 25 0 0 0 27 0 0 0 0 0 0 0 4 0 0 0 0 0 0 0 27 0 0 27 0 0 0 0 
0 0 25 0 0 0 27 0 2 0 0 0 0 0 0 0 0 0 0 0 0 7 27 0 0 27 0 0 0 0 
0 0 25 0 4 0 27 27 27 27 27 27 27 27 34 27 27 27 27 27 27 27 27 0 0 27 0 0 0 0 
0 0 25 0 0 0 0 0 6 0 0 0 0 0 4 0 0 0 0 0 0 0 0 0 6 27 0 0 0 0 
0 0 25 0 0 0 0 0 0 0 0 0 0 0 0 0 0 0 0 0 0 0 0 0 0 27 0 0 0 0 
0 0 25 0 0 2 0 0 0 0 4 0 0 0 0 0 0 4 0 0 0 2 0 0 0 27 0 0 0 0 
0 0 25 8 0 0 0 0 0 0 0 0 0 0 0 0 0 0 0 0 0 0 0 0 8 25 0 0 0 0 
0 0 25 25 25 25 25 25 25 25 25 25 34 25 25 25 25 25 25 25 25 25 25 25 25 25 0 0 0 0 
0 0 0 0 0 0 0 0 25 0 0 0 0 0 0 0 9 25 0 0 0 0 0 0 0 0 0 0 0 0 
0 0 0 0 0 0 0 0 25 0 0 0 0 0 0 0 0 25 0 0 0 0 0 0 0 0 0 0 0 0 
