1 1 1 1 1 1 1 1 1 1 
1 1 1 34 34 1 34 34 1 1 
1 1 1 34 34 34 1 34 34 1 
1 1 1 1 34 34 1 34 1 1 
1 1 1 1 34 34 34 34 1 1 
1 1 25 25 34 34 34 34 1 1 
1 25 25 1 25 1 1 34 1 1 
1 25 25 25 1 1 34 34 1 1 
1 25 25 25 25 34 34 1 1 1 
1 1 1 1 1 1 1 1 1 1 
