1 1 1 1 1 1 1 1 1 1 1 1 1 1 1 1 1 1 1 1 
1 1 1 1 1 1 1 1 1 1 1 1 1 1 1 1 1 1 1 1 
1 1 1 1 1 1 1 1 1 1 1 1 1 1 1 1 1 1 1 1 
1 1 1 1 1 1 1 1 1 1 1 1 1 1 1 1 1 1 1 1 
1 1 1 1 1 1 1 1 25 1 25 1 1 1 1 1 1 1 1 1 
1 1 1 1 1 25 1 1 1 1 1 25 25 1 1 1 1 1 1 1 
1 1 1 1 1 25 1 1 1 1 1 1 25 1 1 1 1 1 1 1 
1 1 1 1 1 25 1 1 1 1 1 1 25 1 1 1 1 1 1 1 
1 1 1 1 1 1 1 1 1 1 1 1 25 1 1 1 1 1 1 1 
1 1 1 1 1 1 1 1 1 1 1 1 1 1 1 1 1 1 1 1 
1 1 1 1 1 1 1 1 1 1 1 1 1 1 1 1 1 1 1 25 
1 1 1 1 1 1 1 1 1 25 1 1 25 1 1 1 1 1 1 1 
1 1 1 1 1 1 1 1 1 25 1 1 25 1 1 1 1 1 1 1 
1 1 1 1 1 1 1 1 1 25 1 1 25 25 25 25 1 1 1 1 
1 1 1 1 1 1 1 1 1 1 1 1 1 1 1 1 1 1 1 1 
1 1 1 1 1 1 1 1 1 1 1 1 1 1 1 1 1 1 1 1 
1 1 1 1 1 1 1 1 1 1 1 1 1 1 1 1 1 1 1 1 
1 1 1 1 1 1 1 1 1 1 1 1 1 1 1 1 1 1 1 1 
1 1 1 1 1 1 1 1 1 1 1 1 1 1 1 1 1 1 1 1 
1 1 1 1 1 1 1 1 1 1 1 1 1 1 1 1 1 1 1 1 
